26 44
┌──────────────────┐    ┌───────┘..└───────┐
│..................│    │..................│
│..................│    │..................│
│..................│    │..................│
│..................└────┘..................│
│..........................................│
│..................┌────┐..................│
│..................│    │..................│
│..................│    │..................│
│.........@........│    │..................│
└───────┐..┌───────┘    │..................│
        │..│            │..................│
    ┌───┘..└───┐        │..................│
    │..........│        │..................│
    └───┐..┌───┘        │..................│
        │..│            │..................│
┌───────┘..└───────┐    │..................│
│..................│    │..................│
│......#....#......│    │..................│
│..................└────┘..................│
│......#....#..............................│
│......┌─..─┐......┌────┐..................│
│......│....│......│    │..................│
│......│....│......│    │..................│
│......└────┘......│    │..................│
└──────────────────┘    └──────────────────┘
